NO ./textures/blue_cloud.xpm
SO ./textures/cat_sunglasses.xpm
WE ./textures/green_cloud.xpm
EA ./textures/purple_cloud.xpm



F 220,100,254
C 225,30,0

11111111111111111111111111111
10000000001100000000000000001
101100000111000000000000000001
1001000000000000000000000000011111111
1111111110110000011100000000000000011
1000000000110000011101111111111111111
11110111111111011100000010001
11110111111111011101010010001
11000000110101011100000010001
10000000000000001100000010001
10W0000000000011010100100011111
11100111110111111111011110000001111
110111 1110101 101111010001111111
11111111 11111111111111111111