NO ./textures/blue_cloud.xpm
SO ./textures/cat_sunglasses.xpm
WE ./textures/green_cloud.xpm
EA ./textures/purple_cloud.xpm

F 220,100,254
C 225,30,0

11111111111111111111111111111
10000000001100000000000000001
1011000001110000000000000011
10010000000000000000000011111111111
1111111110110000011100000000000000011
10000000001100000111011111111111111
11110111111111011100000010001
11110111111111011101010010001
11000000110101011100000010001
10000000000000001100000010001
10N000000000001101010010001111
11100001110101011111011110000001111
110111 1110101 101111010001111111
11111111 1111111 111111111111