NO ./textures/blue_cloud.xpm
SO ./textures/cat_sunglasses.xpm
WE ./textures/white_cloud.xpm
EA ./textures/orange_cloud.xpm

F 0,0,0
C 255,255,255

111111111111111111111
100000000010000000001
100000000000000000001
1000000001N1000000001
100000000010000000001
111111111111111111111
