NO ./textures/blue_cloud.xpm
SO ./textures/cat_sunglasses.xpm
WE ./textures/white_cloud.xpm
EA ./textures/orange_cloud.xpm

F 0,0,0
C 255,255,255

111111111
10001000001
1000N000001
111111111


