NO ./textures/blue_cloud.xpm
SO ./textures/cat_sunglasses.xpm
WE ./textures/white_cloud.xpm
EA ./textures/orange_cloud.xpm

F 0,0,0
C 255,255,255

111111111
100000001
1000N0001
11111111111111


